1111111111111111111111111111111111111111111111111111111111111111111111111111111111111111111111111111111111111111111111111111111111111111111
110000CC10011111111110000CC10110000CC10110000CC10110000CC10110000CC10110000CC10110000CC10110000CC1001110000CC1001110000CC100110000CC1001111
10000000C000000000000000000C000000000C000000000C000000000C000000000C000000000C000000000C000000000C00000000000C00000000000C0000000000C000001
1C00000110C0000000010000001101000000110100000011010000001101000000110100000011010000001101000000110C01000000110C01000000110C0100000110C0101
1C00000000100000000000000000000000000000000000000000000000000000000000000000000000000000000000000001000000000001000000000001000000000010001
1C00000000C0000000000000000000000000000000000000000000000000000000000000000000000000000000000000000C00000000000C00000000000C0000000000C0001
110000CC10011111111110000CC10110000CC10110000CC10110000CC10110000CC10110000CC10110000CC10110000CC1001110000CC1001110000CC100110000CC1001111
10000000C000000000000000000C000000000C000000000C000000000C000000000C000000000C000000000C000000000C00000000000C00000000000C0000000000C000001
1C00000110C0000000010000001101000000110100000011010000001101000000110100000011010000001101000000110C01000000110C01000000110C0100000110C0101
110000CC10011111111110000CC10110000CC10110000CC10110000CC10110000CC10110000CC10110000CC10110000CC1001110000CC1001110000CC100110000CC1001111
10000000C000000000000000000C00000E000C000000000C000000000C000000000C000000000C000000000C000000000C00000000000C00000000000C0000000000C000001
1C00000110C0000000010000001101000000110100000011010000001101000000110100000011010000001101000000110C01000000110C01000000110C0100000110C0101
1C00000000100000000000000000000000000000000000000000000000000000000000000000000000000000000000000001000000000001000000000001000000000010001
1C00000000C0000000000000000000000000000000000000000000000000000000000000000000000000000000000000000C00000000000C00000000000C0000000000C0001
110000CC10011111111110000CC10110000CC10110000CC10110000CC10110000CC10110000CC10110000CC10110000CC1001110000CC1001110000CC100110000CC1001111
10000000C000000000000000000C00000P000C000000000C000000000C000000000C000000000C000000000C000000000C00000000000C00000000000C0000000000C000001
1C00000110C0000000010000001101000000110100000011010000001101000000110100000011010000001101000000110C01000000110C01000000110C0100000110C0101
1C00000000100000000001000000000000000000000000000000000000000000000000000000000000000000000000000001000000000001000000000001000000000010001
1C00000000C0000000000000000000000000000000000000000000000000000000000000000000000000000000000000000C00000000000C00000000000C0000000000C0001
110000CC10011111111110000CC10110000CC10110000CC10110000CC10110000CC10110000CC10110000CC10110000CC1001110000CC1001110000CC100110000CC1001111
10000000C000000000000000000C000000000C000000000C000000000C000000000C000000000C000000000C000000000C00000000000C00000000000C0000000000C000001
1C00000110C0000000010000001101000000110100000011010000001101000000110100000011010000001101000000110C01000000110C01000000110C0100000110C0101
1C00000000100000000000000000000000000000000000000000000000000000000000000000000000000000000000000001000000000001000000000001000000000010001
1C00000000C0000000000000000000000000000000000000000000000000000000000000000000000000000000000000000C00000000000C00000000000C0000000000C0001
1111111111111111111111111111111111111111111111111111111111111111111111111111111111111111111111111111111111111111111111111111111111111111111
