1111111111111111111111111
1E1000000000000C000000001
10100101001CCCCCCCCCC0101
101C01CCC0101010000010101
100P00000C00C0000000000C1
1111111111111111111111111
